
----------S----------------------------------------------------E☺----
*********    *************************************************    ***
*********    *************************************************    ***
*********    *************************************************    ***
*********    *************************************************    ***
*********                                      ***************    ***
*******************************************    ***************    ***
*******************************************    ***************    ***
*******************************************    ***************    ***
*******************************************    ***************    ***
*******************************************    ***************    ***
*******************************************    ***************    ***
*****                                          ***************    ***
*****    *****************************************************    ***
*****    *****************************************************    ***
*****    *****************************************************    ***
*****    *****************************************************    ***
*****    *****************************************************    ***
*****    *****************************************************    ***
*****    *****************************************************    ***
*****    *******                                                  ***
*****    *******    *************************************************
*****    *******    *************************************************
*****    *******    *************************************************
*****    *******    *************************************************
*****    *******    ********                         ****************
*****    *******    ********    *****************    ****************
*****    *******    ********    *****************    ****************
*****    *******    ********    *****************    ****************
*****    *******    ********    *****************    ****************
*****    *******    ********    *****************    ****************
*****    *******    ********    *****************    ****************
*****    *******    ********    *****************    ****************
*****    *******                *****************    ****************
*****    ****************************************    ****************
*****    ****************************************    ****************
*****    ****************************************    ****************
*****    ****************************************    ****************
*****    ****************************************    ****************
*****    ****************************************    ****************
*****    *****                                       ****************
*****    *****    ***************************************************
*****    *****    ***************************************************
*****    *****    ***********                           *************
*****    *****    ***********    *******************    *************
*****    *****    ***********    *******************    *************
*****    *****    ***********    *******************    *************
*****    *****    ***********    *******************    *************
*****    *****                   *******************    *************
*****    *******************************************    *************
*****    *******************************************    *************
*****    *******************************************    *************
*****    *******************************************    *************
*****    *******************************************    *************
*****    *******************************************    *************
*****    *******                                        *************
*****    *******    *************************************************
*****    *******    *************************************************
*****    *******    *************************************************
*****    *******    *************************************************
*****    *******    *************************************************
*****    *******                                           **********
*****    **********************************************    **********
*****    **********************************************    **********
*****    **********************************************    **********
*****    **********************************************    **********
*****                                                      **********
*********************************************************************
*********************************************************************
